NO ./assets/bark.xpm
SO ./assets/planks.xpm
WE ./assets/bookshelf.xpm
EA ./assets/grass.xpm

F 190,200,195
C 37,180,104

111111111111111111111
100000000000000000001
100000000000000000001
100000000111000000001
1000000001 1000000001
100000000111000000001
100000000000000000001
100000000000000000001
111111111111111111111
