NO ./maps/assets/bark.xpm
SO ./maps/assets/planks.xpm
WE ./maps/assets/bookshelf.xpm
EA ./maps/assets/grass.xpm

F 190,200,195
C 37,180,104

111111111111111111111
100000000000000000001
100000000000000000001
1N0000000111000000001
100000000101000000001
1000000001D1000000001
100000000000000000001
100000001000000000011
111111111111111111111