NO ./maps/assets/bark.xpm
SO ./maps/assets/grass.xpm
WE ./maps/assets/bookshelf.xpm
EA ./maps/assets/planks.xpm
DO ./maps/assets/grass.xpm

F 190,200,195
C 37,180,104

111111111111111111111
100000000000000000001
100000000000000000001
100000000111000000001
100000000D01000000001
100000000111000000001
10N000000000000000001
100000000000000000011
111111111111111111111