NO ./maps/mc_assets/brick1.xpm
SO ./maps/mc_assets/brick2.xpm
WE ./maps/mc_assets/brick3.xpm
EA ./maps/mc_assets/brick4.xpm
DO ./maps/mc_assets/door.xpm

F  190,200,195
C 58,50,45

  111111111111111111111
  10000D000000001000001
  101001010100100010000111111
1111010010001D1111111100000011
100000100100D0D00000010111100011
1111010001001D100111100000D01001  
  10S00110100000100D001111111001
  10100D000010000001011      101
  111011111111111111D11111111101
11111000000000000D00000000000001
11111111111111111111111111111111
